Welcome to Revenge! A ravenous dragon has reigned terror on your small town, Draycott, for centuries. Your name is James and you have been training and learning magic since you were born. It's finally your time to avenge everyone that has lost their homes and lives because of this dragon!

Revenge 
An Interactive Fiction by Cole Hulick
Release 1 / Serial number 170227 / Inform 7 build 6M62 (I6/v6.33 lib 6/12N) SD

Draycott
Welcome to the town of Draycott. Crops are burnt to a crisp and livestock is at an all-time low. Houses are in ashes and there are no townspeople to be seen. As you head near the end of the town you see Master Zyliath and speaking to him is greatly advised.

>Hi Zyliath
Hi! how are you...

>inventory
You are carrying:
  Zyliath's Magical staff

* * *

>N
Trail

>e
Forest
You reach the edge of the forest as you stand in front of tightly knit trees. You stare deep into the darkness ahead as if begging permission to enter. You slowly step into the massive realm of woodland and from the first footfall the whole atmosphere changes. The ground was spongy; the earth gently hugs your boots with each step. You look ahead and find a large dark oak tree. Its roots spread throughout the ground as if it were veins, almost as if it is the heart of the entire forest.

>take book
You slowly remove the spell book as vines and bark slowly break and fall to the floor.

>w
Trail

>n
Deep Crevice
Suddenly the trail ends. You look down and find a deep crevice with dark blue water rushing through it. As you look ahead you can see the Tower in the distance, this might be the time to use that spell you found.

>PATHUS
A bridge was built in front of you!

>cross bridge
Tower
You slowly enter the tower, and find yourself surrounded by Dungeon-like walls on everyside. You see an old door northwest of you and stairs northeast of you.

You can see Old Door here.

>x wall
The bricks of the wall had started to crubmle and blacken in age, Cobwebs cover the walls and give you a sense of foreboding. You look more closely and notice a brick out of place?

>take brick
(Brick wall)
That's hardly portable.

>nw
Cellar

* * *

>North
You can't see any such thing.

>n
You can't see any such thing.

>n
You can't see any such thing.

* * *

>attack
What do you want to attack?

>attack zyliath
Violence isn't the answer to this one.

* * *

>health
That's not a verb I recognise.

>status
That's not a verb I recognise.

>status of player
That's not a verb I recognise.

>status
That's not a verb I recognise.

>status of the player
That's not a verb I recognise.

* * *

>hello Zyliath
Hi! how are you...

>x zyliath
You see nothing special about Zyliath.

>hi zyliath
That's not a verb I recognise.

>Hi how are you
That's not a verb I recognise.

>talk Zyliath
I didn't understand that sentence.

>Talk to Zyliath
Hi! how are you...

>undo
Draycott
[Previous turn undone.]

>hello
(Zyliath)
Hi! how are you...

>hello zyliath
Hi! how are you...

* * *

>inventory
You are carrying nothing.

>talk to Zyliath
Hello James, ohyeah I almost forgot here take my staff, this will deffinitly come in handy. With my old body I now spend my days reading and gardening its no use to me anymore.

>inventory
You are carrying:
  Zyliath's Magical staff

>n
Trail

>e
Forest
You reach the edge of the forest as you stand in front of tightly knit trees. You stare deep into the darkness ahead as if begging permission to enter. You slowly step into the massive realm of woodland and from the first footfall the whole atmosphere changes. The ground was spongy; the earth gently hugs your boots with each step. You look ahead and find a large dark oak tree. Its roots spread throughout the ground as if it were veins, almost as if it is the heart of the entire forest.

>x tree
You look more closely and find a mystic looking leather bound hand sized spell book placed on the outside of the tree.

>take spell book
You slowly remove the spell book as vines and bark slowly break and fall to the floor.

* * *

>items
That's not a verb I recognise.

>in
You can't go that way.

* * *

>n
Trail
As you leave the town a dirt path is found underneath you. As you venture on further you find an opening to the forest east of you. Ahead of you the trail keeps north.

>e
Forest
You reach the edge of the forest as you stand in front of tightly knit trees. You stare deep into the darkness ahead as if begging permission to enter. You slowly step into the massive realm of woodland and from the first footfall the whole atmosphere changes. The ground was spongy; the earth gently hugs your boots with each step. You look ahead and find a large dark oak tree. Its roots spread throughout the ground as if it were veins, almost as if it is the heart of the entire forest.

>look inside tree
In Large oak tree is Spell book.

* * *

>e
Forest
You reach the edge of the forest as you stand in front of tightly knit trees. You stare deep into the darkness ahead as if begging permission to enter. You slowly step into the massive realm of woodland and from the first footfall the whole atmosphere changes. The ground was spongy; the earth gently hugs your boots with each step. You look ahead and find a large dark oak tree. Its roots spread throughout the ground as if it were veins, almost as if it is the heart of the entire forest.

>look oak tree
You look more closely and find a mystic looking leather bound hand sized spell book placed on the outside of the tree.

In Large oak tree is Spell book.

* * *

>e
Forest
You reach the edge of the forest as you stand in front of tightly knit trees. You stare deep into the darkness ahead as if begging permission to enter. You slowly step into the massive realm of woodland and from the first footfall the whole atmosphere changes. The ground was spongy; the earth gently hugs your boots with each step. You look ahead and find a large dark oak tree. Its roots spread throughout the ground as if it were veins, almost as if it is the heart of the entire forest.

>look oak trees
You look more closely and find a letter on each of the oak trees! It reads ECHO?

* * *

>take book
You slowly remove the spell book as vines and bark slowly break and fall to the floor.

* * *

>w
Trail
Your jounrey begins here.

>n
Deep Crevice
Suddenly the trail ends. You look down and find a deep crevice with dark blue water rushing through it. As you look ahead you can see the Tower in the distance, this might be the time to use that spell you found.

* * *

>PATHUS
A bridge was built in front of you!

>cross bridge
tower

* * *

>e
Forest
You reach the edge of the forest as you stand in front of tightly knit trees. You stare deep into the darkness ahead as if begging permission to enter. You slowly step into the massive realm of woodland and from the first footfall the whole atmosphere changes. The ground was spongy; the earth gently hugs your boots with each step. You look ahead and find a large dark oak tree. Its roots spread throughout the ground as if it were veins, almost as if it is the heart of the entire forest.

>take book
You slowly remove the spell book as vines and bark slowly break and fall to the floor. Suddenly you hear a thud behind you! You turn your head and find the Defender of the Forest approching you! You have to attack the Defender of the Forest now!

>w
Trail
As you leave the town a dirt path is found underneath you. As you venture on further you find an opening to the forest east of you. Ahead of you the trail ends and seems to drop off?

>e
Forest
You reach the edge of the forest as you stand in front of tightly knit trees. You stare deep into the darkness ahead as if begging permission to enter. You slowly step into the massive realm of woodland and from the first footfall the whole atmosphere changes. The ground was spongy; the earth gently hugs your boots with each step. You look ahead and find a large dark oak tree. Its roots spread throughout the ground as if it were veins, almost as if it is the heart of the entire forest.

>w
Trail
As you leave the town a dirt path is found underneath you. As you venture on further you find an opening to the forest east of you. Ahead of you the trail ends and seems to drop off?

>n
Deep Crevice
Suddenly the trail ends. You look down and find a deep crevice with dark blue water rushing through it. As you look ahead you can see the Tower in the distance, this might be the time to use that spell you found.

* * *

>cross bridge
Tower
You slowly enter the tower, and find yourself surrounded by Dungeon-like walls on everyside. You see an old door northwest of you and stairs northeast of you.

You can see Old Door here.

>take rusty key
Taken.

>ne
First floor
As you head up the stairs a deep roar echos through the tower. As you reach the top of the steps you find yourself surrounded by burnt dead corpses and dungeon-like walls. The whole feeling of the room creeps you out.

>x dead
All of these people must have died trying to slay the dragon. As you search the dead bodies or whats left of them you find a wierd stone in someones pocket?

>x corpses
All of these people must have died trying to slay the dragon. As you search the dead bodies or whats left of them you find a wierd stone in someones pocket?

>x dead corpses
All of these people must have died trying to slay the dragon. As you search the dead bodies or whats left of them you find a wierd stone in someones pocket?

>dead corpses
That's not a verb I recognise.

>take stone
Taken.

>take onyx stone
You already have that.

>x onyx stone
A spherical stone pulsating with magic and power.

>combine onyx stone with heart
You can't see any such thing.

>Combine onyx stone with defender heart
You can't see any such thing.

* * *

>n
Deep Crevice
Suddenly the trail ends. You look down and find a deep crevice with dark blue water rushing through it. As you look ahead you can see the Tower in the distance, this might be the time to use that spell you found.

>PATHUS
A bridge was built in front of you! You can now go on your way and cross over the bridge.

>cross bridge
Tower
You slowly enter the tower, and find yourself surrounded by Dungeon-like walls on everyside. You see an old door northwest of you and stairs northeast of you.

You can see Old Door here.

>n
You can't go that way.

>nw
(first opening Old Door)
It seems to be locked.

>ne
First floor

>n
You can't go that way.

>e
Top of tower
You can see Dragon here.

>attack dragon
Before you could react the dragon hurls fire at you burning you to a crisp.

>x dragon
You see nothing special about Dragon.

>attack dragon
Before you could react the dragon hurls fire at you burning you to a crisp.

* * *

>cross bridge
Tower
You slowly enter the tower, and find yourself surrounded by Dungeon-like walls on everyside. You see an old door northwest of you and stairs northeast of you.

You can see Old Door here.

>nw
Cellar
You can see Old Door here.

>nw
You can't go that way.

* * *

>cross bridge
Tower
You slowly enter the tower, and find yourself surrounded by Dungeon-like walls on everyside. You see an old door northwest of you and stairs northeast of you.

You can see Old Door here.

>s
You can't go that way.

* * *

>cross bridge
Tower
You slowly enter the tower, and find yourself surrounded by Dungeon-like walls on everyside. You see an old door northwest of you and stairs northeast of you.

You can see Old Door here.

>take brick
After taking the brick you see a Rusty key in its place.

>take Rusty key
You already have that.

>Unlock old door
What do you want to unlock Old Door with?

>unlock old door with rusty key
You unlock Old Door.

>n
You can't go that way.

>nw
Cellar

* * *

>cross bridge
Tower
You slowly enter the tower, and find yourself surrounded by Dungeon-like walls on everyside. You see an old door northwest of you and stairs northeast of you.

You can see Old Door here.

>x spell book
You see nothing special about Spell book.

* * *

>cross bridge
Tower
You slowly enter the tower, and find yourself surrounded by Dungeon-like walls on everyside. You see an old door northwest of you and stairs northeast of you.

You can see Old Door here.

>x walls
You can't see any such thing.

>x brick wall
I only understood you as far as wanting to examine Old Brick.

>x dungeon like walls
I only understood you as far as wanting to examine Dungeon like wall.

>x dungeon wall
The bricks of the wall had started to crubmle and blacken in age, Cobwebs cover the walls and give you a sense of foreboding. You look more closely and notice a brick out of place?

>take brick
After taking the brick you see a Rusty key in its place, you reach your hand into the hole and grab the key.

* * *

>PATHUS
A bridge was built in front of you! You can now go on your way and cross over the bridge.

>n
You can't go that way.

>cross bridge
Tower
You slowly enter the tower, and find yourself surrounded by Dungeon-like walls on everyside. You see an old door northwest of you and stairs northeast of you.

You can see Old Door here.

>ne
First floor

>sw
Tower
You slowly enter the tower, and find yourself surrounded by Dungeon-like walls on everyside. You see an old door northwest of you and stairs northeast of you.

You can see Old Door here.

>nw
(first opening Old Door)
It seems to be locked.

* * *

>n
You can't go that way.

>north
You can't go that way.

>cross bridge
Tower
You slowly enter the tower, and find yourself surrounded by Dungeon-like walls on everyside. You see an old door northwest of you and stairs northeast of you.

You can see Old Door here.

* * *

>n
You can't go that way.

>w
You can't go that way.

>e
You can't go that way.

>s
Trail

>n
Deep Crevice
Suddenly the trail ends. You look down and find a deep crevice with dark blue water rushing through it. As you look ahead you can see the Tower in the distance, this might be the time to use that spell you found.

>n
You can't go that way.

>n
You can't go that way.

* * *

>n
Deep Crevice
Suddenly the trail ends. You look down and find a deep crevice with dark blue water rushing through it. As you look ahead you can see the Tower in the distance, this might be the time to use that spell you found.

>cross bridge
You can't go that way.

I beg your pardon?

* * *

>n
Deep Crevice
Suddenly the trail ends. You look down and find a deep crevice with dark blue water rushing through it. As you look ahead you can see the Tower in the distance, this might be the time to use that spell you found.

>echo
a bridge was built in front of you!

I beg your pardon?

>ECHO
a bridge was built in front of you!

I beg your pardon?

* * *

>n
You can't go that way.

>PATHUS
A bridge was built in front of you!

>cross bridge
You can't go that way.

>bridge
That's not a verb I recognise.

>bridge
That's not a verb I recognise.

>x bridge
You see nothing special about Bridge.

>x unlock bridge
You can't see any such thing.

>cross bridge
You can't go that way.

* * *

>n
You can't go that way.

>cross bridge
Deep Crevice
Suddenly the trail ends. You look down and find a deep crevice with dark blue water rushing through it. As you look ahead you can see the Tower in the distance, this might be the time to use that spell you found.

You can see Bridge here.

>PATHUS
A bridge was built in front of you!

>cross bridge
tower
You can see Bridge here.

* * *

>take book
You slowly remove the spell book as vines and bark slowly break and fall to the floor. Suddenly you hear a thud behind you! You turn your head and find the Defender of the Forest approching you! You have to attack the Defender of the Forest now!

>x spell book
You see nothing special about Spell book.

>spell book
That's not a verb I recognise.

* * *

>e
Forest
You reach the edge of the forest as you stand in front of tightly knit trees. You stare deep into the darkness ahead as if begging permission to enter. You slowly step into the massive realm of woodland and from the first footfall the whole atmosphere changes. The ground was spongy; the earth gently hugs your boots with each step. You look ahead and find a large dark oak tree. Its roots spread throughout the ground as if it were veins, almost as if it is the heart of the entire forest.

>take spell book
You slowly remove the spell book as vines and bark slowly break and fall to the floor.

>x spell book
A mystic looking leather bound hand sized spell book, you slowly open it and find a word written inside of the book. It says PATHUS?

* * *

>e
Forest
You reach the edge of the forest as you stand in front of tightly knit trees. You stare deep into the darkness ahead as if begging permission to enter. You slowly step into the massive realm of woodland and from the first footfall the whole atmosphere changes. The ground was spongy; the earth gently hugs your boots with each step. You look ahead and find a large dark oak tree. Its roots spread throughout the ground as if it were veins, almost as if it is the heart of the entire forest.

>w
Trail

>n
Bridge

>n
Tower

* * *

>e
Forest
You reach the edge of the forest as you stand in front of tightly knit trees. You stare deep into the darkness ahead as if begging permission to enter. You slowly step into the massive realm of woodland and from the first footfall the whole atmosphere changes. The ground was spongy; the earth gently hugs your boots with each step. You look ahead and find a large dark oak tree. Its roots spread throughout the ground as if it were veins, almost as if it is the heart of the entire forest.

>x large oak tree
You look more closely and find a mystic looking leather bound hand sized spell book placed on the outside of the tree.

* * *

>e
Forest
You reach the edge of the forest as you stand in front of tightly knit trees. You stare deep into the darkness ahead as if begging permission to enter. You slowly step into the massive realm of woodland and from the first footfall the whole atmosphere changes. The ground was spongy; the earth gently hugs your boots with each step. You look ahead and find a large dark oak tree. Its roots spread throughout the ground as if it were veins, almost as if it is the heart of the entire forest.

>x oak tree
You look more closely and find a mystic looking leather bound hand sized spell book placed on the outside of the tree.

>take spell book
You slowly remove the spell book as vines and bark slowly break and fall to the floor.

>x inside tree
I only understood you as far as wanting to examine inside.

>look inside tree
Large oak tree is empty.

* * *

>take spell book
You slowly remove the spell book as vines and bark slowly break and fall to the floor.

>x spell book
You see nothing special about Spell book.

* * *

>x tree
You look more closely and find a mystic looking leather bound hand sized spell book placed on the outside of the tree.

>take book
You slowly remove the spell book as vines and bark slowly break and fall to the floor.

>x book
You see nothing special about Spell book.

>x spell book
You see nothing special about Spell book.

>look sPELL BOOK
You see nothing special about Spell book.

>slepp book
That's not a verb I recognise.

>spell book
That's not a verb I recognise.

>x spell book
You see nothing special about Spell book.

* * *

>n
Trail
As you leave the town a dirt path is found underneath you. As you venture on further you find an opening to the forest east of you. Ahead of you the trail keeps north.

>n
You can't see any such thing.

>n
You can't go that way.

* * *

>PATHUS
A bridge was built in front of you!

>n
You can't go that way.

* * *

>w
You can't go that way.

>w
You can't go that way.

>s
Trail

>s
Draycott
Welcome to the town of Draycott. Crops are burnt to a crisp and livestalk is at an all time low. Houses are in ashes and there are no townspeople to be seen. As you head near the end of the town you see your Master Zyliath.

>n
Trail

* * *

>take book
You slowly remove the spell book as vines and bark slowly break and fall to the floor.

>e
You can't go that way.

>w
Trail

* * *

>n
Trail
As you leave the town a dirt path is found underneath you. As you venture on further you find an opening to the forest east of you. Ahead of you the trail keeps north.

>north
You can't go that way.

>e
You can't go that way.

* * *

>n
Trail
As you leave the town a dirt path is found underneath you. As you venture on further you find an opening to the forest east of you. Ahead of you the trail keeps north.

>s
Draycott
Welcome to the town of Draycott. Crops are burnt to a crisp and livestalk is at an all time low. Houses are in ashes and there are no townspeople to be seen. As you head near the end of the town you see your Master Zyliath, you should go talk to him.

>e
You can't go that way.

>w
Forest

>w
You can't go that way.

>n
You can't go that way.

* * *

>s
Draycott
Welcome to the town of Draycott. Crops are burnt to a crisp and livestalk is at an all time low. Houses are in ashes and there are no townspeople to be seen. As you head near the end of the town you see your Master Zyliath, you should go talk to him.

>n
Town

I beg your pardon?

* * *

>s
Draycott
Welcome to the town of Draycott. Crops are burnt to a crisp and livestalk is at an all time low. Houses are in ashes and there are no townspeople to be seen. As you head near the end of the town you see your Master Zyliath, you should go talk to him.

>s
bridge

>e
You can't go that way.

>n
Town

* * *

>s
bridge

>s
tower

>s
You can't go that way.

>s
You can't go that way.

* * *

>s
Draycott
Welcome to the town of Draycott. Crops are burnt to a crisp and livestalk is at an all time low. Houses are in ashes and there are no townspeople to be seen. As you head near the end of the town you see your Master Zyliath, you should go talk to him.

>take staff
You can't see any such thing.

>talk to zyliath
Hello James, I've known you since you were a child and look at you now im so proud to be your teacher. I almost forgot here take my staff, this will deffinitly come in handy who knows what you will run into on your adventure. With my old body I now spend my days reading and gardening its no use to me anymore. I wish you the best of luck james you can do it!

>n
Trail
As you leave the town a dirt path is found underneath you. As you venture on further you find an opening to the forest east of you. Ahead of you the trail keeps north.

* * *

>take book
You slowly remove the spell book as vines and bark slowly break and fall to the floor. Suddenly you hear a thud behind you! You turn your head and find the Defender of the Forest approching you! You have to attack the Defender of the Forest now!

>attack defender
You raise your staff in the air, an orb of blue light appears from your staff and strikes your opponent killing him in an instant. As the defender gets vaporized its heart slowly falls to the ground.
you now have the defender of the forest's heart.

>x heart
A heart made of pure emerald. This could be used to combine with something.

>w
Trail
As you leave the town a dirt path is found underneath you. As you venture on further you find an opening to the forest east of you. Ahead of you the trail keeps north.

>n
Deep Crevice
Suddenly the trail ends. You look down and find a deep crevice with dark blue water rushing through it. As you look ahead you can see the Tower in the distance, this might be the time to use that spell you found.

* * *

>PATHUS
A bridge was built in front of you! You can now go on your way and cross over the bridge.

>cross
You must supply a noun.

>cross bridge
Tower
You slowly enter the tower, and find yourself surrounded by Dungeon-like walls on everyside. The brick walls are covered in dust and cobwebs their must be something hidden within these walls. You see an old door northwest of you and stairs northeast of you.

You can see Old Door here.

>ne
First floor
As you head up the stairs a deep roar echos through the tower. As you reach the top of the steps you find yourself surrounded by burnt dead corpses and dungeon-like walls. The whole feeling of the room creeps you out.

>take onyx stone
Taken.

* * *

>saga
That's not a verb I recognise.

>x saga
You can't see any such thing.

>combine defender of the forests heart with onyx stone
I didn't understand that sentence.

>stone combine heart
That's not a verb I recognise.

* * *

>s
Draycott
Welcome to the town of Draycott. Crops are burnt to a crisp and livestalk is at an all time low. Houses are in ashes and there are no townspeople to be seen. As you head near the end of the town you see your Master Zyliath, you should go talk to him.

>talk to zyliath
Hello James, ohyeah I almost forgot here take my staff, this will deffinitly come in handy. With my old body I now spend my days reading and gardening its no use to me anymore.

>n
Trail
As you leave the town a dirt path is found underneath you. As you venture on further you find an opening to the forest east of you. Ahead of you the trail ends and seems to drop off?

>e
Forest
You reach the edge of the forest as you stand in front of tightly knit trees. You stare deep into the darkness ahead as if begging permission to enter. You slowly step into the massive realm of woodland and from the first footfall the whole atmosphere changes. The ground was spongy; the earth gently hugs your boots with each step. You look ahead and find a large dark oak tree. Its roots spread throughout the ground as if it were veins, almost as if it is the heart of the entire forest.

>take book
You slowly remove the spell book as vines and bark slowly break and fall to the floor. Suddenly you hear a thud behind you! As you slowly turn your head you notice a large darkness infront of you blocking your path.

>attack defender
You raise your staff in the air, an orb of blue light appears from your staff and strikes your opponent killing him in an instant. As the defender gets vaporized its heart slowly falls to the ground.
you now have the defender of the forest's heart.

>w
Trail
As you leave the town a dirt path is found underneath you. As you venture on further you find an opening to the forest east of you. Ahead of you the trail ends and seems to drop off?

* * *

>cross bridge
Tower
You slowly enter the tower, and find yourself surrounded by Dungeon-like walls on everyside. You see an old door northwest of you and stairs northeast of you.

You can see Old Door here.

>ne
First floor
As you head up the stairs a deep roar echos through the tower. As you reach the top of the steps you find yourself surrounded by burnt dead corpses and dungeon-like walls. The whole feeling of the room creeps you out.

>x dead corpses
All of these people must have died trying to slay the dragon. As you search the dead bodies or whats left of them you find a wierd stone in someones pocket?

>take stone
Taken.

>x stone
A spherical stone pulsating with magic and power.

* * *

>s
Draycott
Welcome to the town of Draycott. Crops are burnt to a crisp and livestalk is at an all time low. Houses are in ashes and there are no townspeople to be seen. As you head near the end of the town you see your Master Zyliath, you should go talk to him.

>w
Forest

>tree
compass (580011) 
  the north
  the northeast
  the northwest
  the south
  the southeast
  the southwest
  the east
  the west
  the up
  the down
  the inside
  the outside
(darkness object) (580043) 
(Inform Parser) (580075) 
(Inform Library) (580107) 
(property_numberspace_forcer) (580139) 
(ValuePropertyHolder_43) (580203) 
(ValuePropertyHolder_47) (580235) 
Town (581195) 
Trail (581227) 
Forest (581259) 
  yourself
  Tree
bridge (581323) 
tower (581355) 
cellar (581387) 
first floor (581419) 
top of tower (581451)

* * *

>n\
That's not a verb I recognise.

>n
You can't go that way.

* * *

>north
Trail
As you leave the town a dirt path is found underneath you. As you venture on further you find an opening to the forest east of you. Ahead of you the trail ends and seems to drop off?

>east
Forest
You reach the edge of the forest as you stand in front of tightly knit trees. You stare deep into the darkness ahead as if begging permission to enter. You slowly step into the massive realm of woodland and from the first footfall the whole atmosphere changes. The ground was spongy; the earth gently hugs your boots with each step. You look ahead and find a large dark oak tree. Its roots spread throughout the ground as if it were veins, almost as if it is the heart of the entire forest.

>x oak tree
You look more closely and find a mystic looking leather bound hand sized spell book placed on the outside of the tree.

>take spell book
You slowly remove the spell book as vines and bark slowly break and fall to the floor. Suddenly you hear a thud behind you! As you slowly turn your head you notice a large darkness infront of you blocking your path.

>west
Trail
As you leave the town a dirt path is found underneath you. As you venture on further you find an opening to the forest east of you. Ahead of you the trail ends and seems to drop off?

>east
Forest
You reach the edge of the forest as you stand in front of tightly knit trees. You stare deep into the darkness ahead as if begging permission to enter. You slowly step into the massive realm of woodland and from the first footfall the whole atmosphere changes. The ground was spongy; the earth gently hugs your boots with each step. You look ahead and find a large dark oak tree. Its roots spread throughout the ground as if it were veins, almost as if it is the heart of the entire forest.

* * *

>x oak tree
You look more closely and find a mystic looking leather bound hand sized spell book placed on the outside of the tree.

>take spell book
You already have that.

>attack defender
You try to punch the Defender he is not fazed by it. He grabs you by the neck and throws you to the ground instantly killing you.

    *** The End ***

Would you like to RESTART, RESTORE a saved game, QUIT or UNDO the last command?

>restart
Welcome to Revenge! A ravenous dragon has reigned terror on your small town Draycott, for centuries. Your name is James, you have been training and learning magic since you were born. Its finally your time to avenge everyone that has lost their homes and life's from this dragon!

Revenge 
An Interactive Fiction by Cole Hulick
Release 1 / Serial number 170223 / Inform 7 build 6M62 (I6/v6.33 lib 6/12N) SD

Draycott
Welcome to the town of Draycott. Crops are burnt to a crisp and livestalk is at an all time low. Houses are in ashes and there are no townspeople to be seen. As you head near the end of the town you see your Master Zyliath.

>nort
That's not a verb I recognise.

>n
Trail
As you leave the town a dirt path is found underneath you. As you venture on further you find an opening to the forest east of you. Ahead of you the trail ends and seems to drop off?

* * *

>take book
You slowly remove the spell book as vines and bark slowly break and fall to the floor. Suddenly you hear a thud behind you! As you slowly turn your head you notice a large darkness infront of you blocking your path.

>use book on defender
That's not a verb I recognise.

>use spell book
That's not a verb I recognise.

* * *

I beg your pardon?

>run
You'll have to say which compass direction to go in.

>west
Trail
As you leave the town a dirt path is found underneath you. As you venture on further you find an opening to the forest east of you. Ahead of you the trail ends and seems to drop off?

>south
Draycott
Welcome to the town of Draycott. Crops are burnt to a crisp and livestalk is at an all time low. Houses are in ashes and there are no townspeople to be seen. As you head near the end of the town you see your Master Zyliath.

>north
Trail
As you leave the town a dirt path is found underneath you. As you venture on further you find an opening to the forest east of you. Ahead of you the trail ends and seems to drop off?

* * *

>east
Forest
You reach the edge of the forest as you stand in front of tightly knit trees. You stare deep into the darkness ahead as if begging permission to enter. You slowly step into the massive realm of woodland and from the first footfall the whole atmosphere changes. The ground was spongy; the earth gently hugs your boots with each step. You look ahead and find a large dark oak tree. Its roots spread throughout the ground as if it were veins, almost as if it is the heart of the entire forest.

>west
Trail
As you leave the town a dirt path is found underneath you. As you venture on further you find an opening to the forest east of you. Ahead of you the trail ends and seems to drop off?

* * *

>use spell book to attack defender
That's not a verb I recognise.

>use spell book
That's not a verb I recognise.

>x spell book
A mystic looking leather bound hand sized spell book, you slowly open it and find a word written inside of the book. It says PATHUS?

>west
Trail
As you leave the town a dirt path is found underneath you. As you venture on further you find an opening to the forest east of you. Ahead of you the trail ends and seems to drop off?

* * *

I beg your pardon?

>east
Forest
You reach the edge of the forest as you stand in front of tightly knit trees. You stare deep into the darkness ahead as if begging permission to enter. You slowly step into the massive realm of woodland and from the first footfall the whole atmosphere changes. The ground was spongy; the earth gently hugs your boots with each step. You look ahead and find a large dark oak tree. Its roots spread throughout the ground as if it were veins, almost as if it is the heart of the entire forest.

* * *

I beg your pardon?

>west
Trail
As you leave the town a dirt path is found underneath you. As you venture on further you find an opening to the forest east of you. Ahead of you the trail ends and seems to drop off?

* * *

I beg your pardon?

I beg your pardon?

>north
Trail
As you leave the town a dirt path is found underneath you. As you venture on further you find an opening to the forest east of you. Ahead of you the trail ends and seems to drop off?

* * *

>x oak tree
You look more closely and find a mystic looking leather bound hand sized spell book placed on the outside of the tree.

>take book
You already have that.

>i
You are carrying:
  Spell book

>west
Trail
As you leave the town a dirt path is found underneath you. As you venture on further you find an opening to the forest east of you. Ahead of you the trail ends and seems to drop off?

* * *

I beg your pardon?

>use book
That's not a verb I recognise.

>use spell book
That's not a verb I recognise.

>east
Forest
You reach the edge of the forest as you stand in front of tightly knit trees. You stare deep into the darkness ahead as if begging permission to enter. You slowly step into the massive realm of woodland and from the first footfall the whole atmosphere changes. The ground was spongy; the earth gently hugs your boots with each step. You look ahead and find a large dark oak tree. Its roots spread throughout the ground as if it were veins, almost as if it is the heart of the entire forest.

* * *

I beg your pardon?

>south
Draycott
Welcome to the town of Draycott. Crops are burnt to a crisp and livestalk is at an all time low. Houses are in ashes and there are no townspeople to be seen. As you head near the end of the town you see your Master Zyliath.

>talk to master zyliath
You can't see any such thing.

>x master zyliath
You can't see any such thing.

>talk to zyliath
Hello James, I've known you since you were a child and look at you now im so proud to be your teacher. I almost forgot here take my staff, this will deffinitly come in handy who knows what you will run into on your adventure. With my old body I now spend my days reading and gardening its no use to me anymore. I wish you the best of luck james you can do it!

>i
You are carrying:
  Zyliath's Magical staff
  Spell book

>north
Trail
As you leave the town a dirt path is found underneath you. As you venture on further you find an opening to the forest east of you. Ahead of you the trail ends and seems to drop off?

* * *

>east
Forest
You reach the edge of the forest as you stand in front of tightly knit trees. You stare deep into the darkness ahead as if begging permission to enter. You slowly step into the massive realm of woodland and from the first footfall the whole atmosphere changes. The ground was spongy; the earth gently hugs your boots with each step. You look ahead and find a large dark oak tree. Its roots spread throughout the ground as if it were veins, almost as if it is the heart of the entire forest.

>attack defender
You raise your staff in the air, an orb of blue light appears from your staff and strikes your opponent killing him in an instant. As the defender gets vaporized its heart slowly falls to the ground.
you now have the defender of the forest's heart.

>i
You are carrying:
  a Forest Defender heart
  Zyliath's Magical staff
  Spell book

>west
Trail
As you leave the town a dirt path is found underneath you. As you venture on further you find an opening to the forest east of you. Ahead of you the trail ends and seems to drop off?

* * *

I beg your pardon?

>x trail
You can't see any such thing.

>x forest
A heart made of pure emerald.

>x dirt path
You can't see any such thing.

>x path
You can't see any such thing.

>east
Forest
You reach the edge of the forest as you stand in front of tightly knit trees. You stare deep into the darkness ahead as if begging permission to enter. You slowly step into the massive realm of woodland and from the first footfall the whole atmosphere changes. The ground was spongy; the earth gently hugs your boots with each step. You look ahead and find a large dark oak tree. Its roots spread throughout the ground as if it were veins, almost as if it is the heart of the entire forest.

* * *

>west
Trail
As you leave the town a dirt path is found underneath you. As you venture on further you find an opening to the forest east of you. Ahead of you the trail ends and seems to drop off?

>nr
That's not a verb I recognise.

>n
Deep Crevice
Suddenly the trail ends. You look down and find a deep crevice with dark blue water rushing through it. As you look ahead you can see the Tower in the distance, this might be the time to use that spell you found.

* * *

>n
You can't go that way.

>s
Trail
As you leave the town a dirt path is found underneath you. As you venture on further you find an opening to the forest east of you. Ahead of you the trail ends and seems to drop off?

>n
Deep Crevice
Suddenly the trail ends. You look down and find a deep crevice with dark blue water rushing through it. As you look ahead you can see the Tower in the distance, this might be the time to use that spell you found.

* * *

>n
You can't go that way.

>east
You can't go that way.

>west
You can't go that way.

>n
You can't go that way.

>walk on bridge
You can't see any such thing.

>go on bridge
You can't see any such thing.

>walk over bridge
You can't see any such thing.

>cross bridge
Tower
You slowly enter the tower, and find yourself surrounded by Dungeon-like walls on everyside. You see an old door northwest of you and stairs northeast of you.

You can see Old Door here.

* * *

>ne
First floor
As you head up the stairs a deep roar echos through the tower. As you reach the top of the steps you find yourself surrounded by burnt dead corpses and dungeon-like walls. The whole feeling of the room creeps you out.

>e
Top of tower
As you take each step the whole atmosphere begins to change, as if a dark powerfull presence is watching your everystep. You soon reach the top of the tower, the wind blows rapidly into your face and clouds begin to form above you blocking out the sun. You look ahead and see the Dragon! It screaches out a roar and stares right into your eyes. Your heart starts rapidly speeding up! YOU NEED TO SLAY THE DRAGON NOW!

Fierce eyes sit deep within the dragon's skull. Two horns sit atop its head, several rows of small crystal growths run down the dragons spine. Colossal wings grow from its side, large ruby scales cover the dragon's body.

>attack dragon
Before you could react the dragon hurls fire at you burning you to a crisp.

    *** The End ***

Would you like to RESTART, RESTORE a saved game, QUIT or UNDO the last command?

>rest
Please give one of the answers above.

Would you like to RESTART, RESTORE a saved game, QUIT or UNDO the last command?

>restart
Welcome to Revenge! A ravenous dragon has reigned terror on your small town Draycott, for centuries. Your name is James, you have been training and learning magic since you were born. Its finally your time to avenge everyone that has lost their homes and life's from this dragon!

Revenge 
An Interactive Fiction by Cole Hulick
Release 1 / Serial number 170223 / Inform 7 build 6M62 (I6/v6.33 lib 6/12N) SD

Draycott
Welcome to the town of Draycott. Crops are burnt to a crisp and livestalk is at an all time low. Houses are in ashes and there are no townspeople to be seen. As you head near the end of the town you see your Master Zyliath.

>nroth
That's not a verb I recognise.

>n
Trail
As you leave the town a dirt path is found underneath you. As you venture on further you find an opening to the forest east of you. Ahead of you the trail ends and seems to drop off?

* * *

>e
Forest
You reach the edge of the forest as you stand in front of tightly knit trees. You stare deep into the darkness ahead as if begging permission to enter. You slowly step into the massive realm of woodland and from the first footfall the whole atmosphere changes. The ground was spongy; the earth gently hugs your boots with each step. You look ahead and find a large dark oak tree. Its roots spread throughout the ground as if it were veins, almost as if it is the heart of the entire forest.

>x oak
You look more closely and find a mystic looking leather bound hand sized spell book placed on the outside of the tree.

>take book
You slowly remove the spell book as vines and bark slowly break and fall to the floor. Suddenly you hear a thud behind you! As you slowly turn your head you notice a large darkness infront of you blocking your path.

>west
Trail
As you leave the town a dirt path is found underneath you. As you venture on further you find an opening to the forest east of you. Ahead of you the trail ends and seems to drop off?

>e
Forest
You reach the edge of the forest as you stand in front of tightly knit trees. You stare deep into the darkness ahead as if begging permission to enter. You slowly step into the massive realm of woodland and from the first footfall the whole atmosphere changes. The ground was spongy; the earth gently hugs your boots with each step. You look ahead and find a large dark oak tree. Its roots spread throughout the ground as if it were veins, almost as if it is the heart of the entire forest.

>west
Trail
As you leave the town a dirt path is found underneath you. As you venture on further you find an opening to the forest east of you. Ahead of you the trail ends and seems to drop off?

>s
Draycott
Welcome to the town of Draycott. Crops are burnt to a crisp and livestalk is at an all time low. Houses are in ashes and there are no townspeople to be seen. As you head near the end of the town you see your Master Zyliath.

>talk to zyliath
Hello James, I've known you since you were a child and look at you now im so proud to be your teacher. I almost forgot here take my staff, this will deffinitly come in handy who knows what you will run into on your adventure. With my old body I now spend my days reading and gardening its no use to me anymore. I wish you the best of luck james you can do it!

* * *

>i
You are carrying:
  Zyliath's Magical staff
  Spell book

>n
Trail
As you leave the town a dirt path is found underneath you. As you venture on further you find an opening to the forest east of you. Ahead of you the trail ends and seems to drop off?

* * *

>e
Forest
You reach the edge of the forest as you stand in front of tightly knit trees. You stare deep into the darkness ahead as if begging permission to enter. You slowly step into the massive realm of woodland and from the first footfall the whole atmosphere changes. The ground was spongy; the earth gently hugs your boots with each step. You look ahead and find a large dark oak tree. Its roots spread throughout the ground as if it were veins, almost as if it is the heart of the entire forest.

>attack defender
You raise your staff in the air, an orb of blue light appears from your staff and strikes your opponent killing him in an instant. As the defender gets vaporized its heart slowly falls to the ground.
you now have the defender of the forest's heart.

* * *

>n
Deep Crevice
Suddenly the trail ends. You look down and find a deep crevice with dark blue water rushing through it. As you look ahead you can see the Tower in the distance, this might be the time to use that spell you found.

>pathus
A bridge was built in front of you!

>cross bridge
Tower
You slowly enter the tower, and find yourself surrounded by Dungeon-like walls on everyside. You see an old door northwest of you and stairs northeast of you.

You can see Old Door here.

>northeast
First floor
As you head up the stairs a deep roar echos through the tower. As you reach the top of the steps you find yourself surrounded by burnt dead corpses and dungeon-like walls. The whole feeling of the room creeps you out.

>southwest
Tower
You slowly enter the tower, and find yourself surrounded by Dungeon-like walls on everyside. You see an old door northwest of you and stairs northeast of you.

You can see Old Door here.

>e
You can't go that way.

>s
You can't go that way.

>south
You can't go that way.

>northwest
(first opening Old Door)
It seems to be locked.

>open door
It seems to be locked.

>south
You can't go that way.

* * *

>northwest
(first opening Old Door)
It seems to be locked.

>i
You are carrying:
  a Forest Defender heart
  Zyliath's Magical staff
  Spell book

>northeast
First floor
As you head up the stairs a deep roar echos through the tower. As you reach the top of the steps you find yourself surrounded by burnt dead corpses and dungeon-like walls. The whole feeling of the room creeps you out.

>east
Top of tower
As you take each step the whole atmosphere begins to change, as if a dark powerfull presence is watching your everystep. You soon reach the top of the tower, the wind blows rapidly into your face and clouds begin to form above you blocking out the sun. You look ahead and see the Dragon! It screaches out a roar and stares right into your eyes. Your heart starts rapidly speeding up! YOU NEED TO SLAY THE DRAGON NOW!

Fierce eyes sit deep within the dragon's skull. Two horns sit atop its head, several rows of small crystal growths run down the dragons spine. Colossal wings grow from its side, large ruby scales cover the dragon's body.

>west
First floor
As you head up the stairs a deep roar echos through the tower. As you reach the top of the steps you find yourself surrounded by burnt dead corpses and dungeon-like walls. The whole feeling of the room creeps you out.

>southwest
Tower
You slowly enter the tower, and find yourself surrounded by Dungeon-like walls on everyside. You see an old door northwest of you and stairs northeast of you.

You can see Old Door here.

>x old door
You see nothing special about Old Door.

>x door
You see nothing special about Old Door.

>x walls
You can't see any such thing.

>x tower
You can't see any such thing.

>x stairs
You can't see any such thing.

>x dungeon-like walls
You can't see any such thing.

>x brick wall
The bricks of the wall had started to crubmle and blacken in age, Cobwebs cover the walls and give you a sense of foreboding. You look more closely and notice a brick out of place?

>break brick
(Brick wall)
Violence isn't the answer to this one.

>attack brick
(Brick wall)
Violence isn't the answer to this one.

>take brick
(Brick wall)
That's hardly portable.

>take brick
(Brick wall)
That's hardly portable.

>take old brick
After taking the brick you see a Rusty key in its place, you reach your hand into the hole and grab the key.

>take key
You already have that.

>open old door
It seems to be locked.

>use key on old door
That's not a verb I recognise.

>use key to open door
That's not a verb I recognise.

>x old door
You see nothing special about Old Door.

>use key on door
That's not a verb I recognise.

>open old door
It seems to be locked.

>i
You are carrying:
  Rusty Key
  a Forest Defender heart
  Zyliath's Magical staff
  Spell book

>use key on old door
That's not a verb I recognise.

>use key to open old door
That's not a verb I recognise.

>use rusty key to open door
That's not a verb I recognise.

>use rusty key to open old door
That's not a verb I recognise.

>use rusty key to open door
That's not a verb I recognise.

>use rusty key
That's not a verb I recognise.

>ne
First floor
As you head up the stairs a deep roar echos through the tower. As you reach the top of the steps you find yourself surrounded by burnt dead corpses and dungeon-like walls. The whole feeling of the room creeps you out.

>sw
Tower
You slowly enter the tower, and find yourself surrounded by Dungeon-like walls on everyside. You see an old door northwest of you and stairs northeast of you.

You can see Old Door here.

* * *

>nw
(first opening Old Door)
It seems to be locked.

>use rusty key on door
That's not a verb I recognise.

>open old door with rusty key
You unlock Old Door.

>nw
(first opening Old Door)

Cellar
The door slowly creaks open, a musty smell fills your nose. The outdoor sunlight fills the darkend room. As your eyes adjust something shiny grabs your attention. You walk towards it and wipe off the thick layer of dust settling on the item, and notice its Chainmail armour.

You can see Old Door here.

>take chainmail armour
You can't see any such thing.

>take armour
You can't see any such thing.

>i
You are carrying:
  Rusty Key
  a Forest Defender heart
  Zyliath's Magical staff
  Spell book

>southeast
Tower
You slowly enter the tower, and find yourself surrounded by Dungeon-like walls on everyside. You see an old door northwest of you and stairs northeast of you.

You can see Old Door here.

* * *

>ne
First floor
As you head up the stairs a deep roar echos through the tower. As you reach the top of the steps you find yourself surrounded by burnt dead corpses and dungeon-like walls. The whole feeling of the room creeps you out.

>x room
You can't see any such thing.

>x walls
You can't see any such thing.

>x corpses
All of these people must have died trying to slay the dragon. As you search the dead bodies or whats left of them you find an onyx stone an extremly rare mage rock. East of you are stairs leading to the top of the tower.

>take onyx stone
Taken.

>take mage rock
You can't see any such thing.

* * *

I beg your pardon?

>east
Top of tower
As you take each step the whole atmosphere begins to change, as if a dark powerfull presence is watching your everystep. You soon reach the top of the tower, the wind blows rapidly into your face and clouds begin to form above you blocking out the sun. You look ahead and see the Dragon! It screaches out a roar and stares right into your eyes. Your heart starts rapidly speeding up! YOU NEED TO SLAY THE DRAGON NOW!

Fierce eyes sit deep within the dragon's skull. Two horns sit atop its head, several rows of small crystal growths run down the dragons spine. Colossal wings grow from its side, large ruby scales cover the dragon's body.

* * *

>west
First floor
As you head up the stairs a deep roar echos through the tower. As you reach the top of the steps you find yourself surrounded by burnt dead corpses and dungeon-like walls. The whole feeling of the room creeps you out.

>x walls
You can't see any such thing.

* * *

>x corpses
All of these people must have died trying to slay the dragon. As you search the dead bodies or whats left of them you find an onyx stone an extremly rare mage rock. East of you are stairs leading to the top of the tower.

>i
You are carrying:
  Onyx Stone
  Rusty Key
  a Forest Defender heart
  Zyliath's Magical staff
  Spell book

* * *

>s
Trail

>w
Forest

* * *

>take all
There are none at all available!

* * *

>talk to Zyliath
Hello James, I've known you since you were a child and look at you now I am so proud to be your teacher. I almost forgot here take my staff, this will definitely come in handy. Who knows what you will run into on your adventure. With my old body I now spend my days reading and gardening it's no use to me anymore. I wish you the best of luck James you can do it!

>n
Trail
As you leave the town a dirt path is found underneath you. As you venture on further you find an opening to the forest east of you. Ahead of you the trail keeps heading north.

>e
Forest
You reach the edge of the forest as you stand in front of tightly knit trees. You stare deep into the darkness ahead as if begging permission to enter. You slowly step into the massive realm of woodland and from the first footfall the whole atmosphere changes. The ground was spongy; the earth gently hugs your boots with each step. You look ahead and find a large dark oak tree. Its roots spread throughout the ground as if it were veins, almost as if it is the heart of the entire forest.

* * *

>take book
You slowly remove the spell book as vines and bark slowly break and fall to the floor. Suddenly you hear a thud behind you! As you slowly turn your head you notice a large darkness infront of you blocking your path.

>attack Defender
You raise your staff in the air, an orb of blue light appears from your staff and strikes your opponent killing him in an instant. As the defender gets vaporized its heart slowly falls to the ground.
you now have the defender of the forest's heart.

>ii
That's not a verb I recognise.

>i
You are carrying:
  a Forest Defender heart
  Spell book
  Zyliath's Magical staff

* * *

>attack Defender
You raise your staff in the air, an orb of blue light appears from your staff and strikes your opponent killing him in an instant. As the defender gets vaporized its heart slowly falls to the ground.
you now have the defender of the forest's heart.

>n
You can't go that way.

>w
Trail
As you leave the town a dirt path is found underneath you. As you venture on further you find an opening to the forest east of you. Ahead of you the trail ends and seems to drop off?

* * *

>cross bridge
Tower
You slowly enter the tower, and find yourself surrounded by Dungeon-like walls on everyside. You see an old door northwest of you and stairs northeast of you.

You can see Old Door here.

>nw
(first opening Old Door)
It seems to be locked.

>ne
First floor
As you head up the stairs a deep roar echos through the tower. As you reach the top of the steps you find yourself surrounded by burnt dead corpses and dungeon-like walls. The whole feeling of the room creeps you out.

* * *

I beg your pardon?

>x saga
You can't see any such thing.

* * *

>x oak tree
You look more closely and find a mystic looking leather bound hand sized spell book placed on the outside of the tree.

>take spell book
You slowly remove the spell book as vines and bark slowly break and fall to the floor. Suddenly you hear a thud behind you! You turn your head and find the Defender of the Forest approaching you! You have to attack the Defender of the Forest now!

>Attack defender
You raise your staff in the air, an orb of blue light appears from your staff and strikes your opponent killing him in an instant. As the defender gets vaporized its heart slowly falls to the ground.
you now have the defender of the forest's heart.

>x heart
A heart made of pure emerald. This item is great for combining with stones to make powerful magic.

>x boo
You can't see any such thing.

>x book
A mystic looking leather bound hand sized spell book, you slowly open it and find a word written inside of the book. It says PATHUS?

>w
Trail
As you leave the town a dirt path is found underneath you. As you venture on further you find an opening to the forest east of you. Ahead of you the trail keeps heading north.

>n
Deep Crevice
Suddenly the trail ends. You look down and find a deep crevice with dark blue water rushing through it. As you look ahead you can see the Tower in the distance, this might be the time to use that spell you found.

* * *

>PATHUS
A bridge was built in front of you! You can now go on your way and cross over the bridge.

>cross bridge
Tower
You slowly enter the tower, and find yourself surrounded by Dungeon-like walls on every side. The brick walls are covered in dust and cobwebs there must be something hidden within these walls. You see an old door northwest of you and stairs northeast of you.

You can see Old Door here.

>x brick wall
I only understood you as far as wanting to examine Old Brick.

>x brick walls
I only understood you as far as wanting to examine Old Brick.

>x dungeon like walls
I only understood you as far as wanting to examine Dungeon like wall.

>x wall
The bricks of the wall had started to crumble and blacken in age, Cobwebs cover the walls and give you a sense of foreboding. You look more closely and notice a brick out of place?

>take brick
After taking the brick you see a Rusty key in its place, you reach your hand into the hole and grab the key.

>nw
(first opening Old Door)
It seems to be locked.

>unlock door with key
You unlock Old Door.

>nw
(first opening Old Door)

Cellar
The door slowly creaks open; a musty smell fills your nose. The outdoor sunlight fills the darkened room. As your eyes adjust something shiny grabs your attention. You walk towards it and wipe off the thick layer of dust settling on the item, and notice its an Onyx stone!

You can see Old Door here.

>take onyx stone
Taken.

>se
Tower
You slowly enter the tower, and find yourself surrounded by Dungeon-like walls on every side. The brick walls are covered in dust and cobwebs there must be something hidden within these walls. You see an old door northwest of you and stairs northeast of you.

You can see Old Door here.

>ne
First floor
As you head up the stairs a deep roar echo's through the tower. As you reach the top of the steps you find yourself surrounded by burnt dead corpses and dungeon-like walls. The whole feeling of the room creeps you out.

* * *

I beg your pardon?

>x onyx stone
A spherical stone pulsating with magic and power. This is just the stone you need to combine with your heart you got.

>x saga
You can't see any such thing.

>e
Top of tower
As you take each step the whole atmosphere begins to change, as if a dark powerful presence is watching your every step. You soon reach the top of the tower, the wind blows rapidly into your face and clouds begin to form above you blocking out the sun. You look ahead and see the Dragon! It screeches out a roar and stares right into your eyes. Your heart starts rapidly speeding up! YOU NEED TO SLAY THE DRAGON NOW!

Fierce eyes sit deep within the dragon's skull. Two horns sit atop its head, several rows of small crystal growths run down the dragon's spine. Colossal wings grow from its side; large ruby scales cover the dragon's body.

>attack dragon
Before you could react the dragon hurls fire at you burning you to a crisp.

    *** The End ***

Would you like to RESTART, RESTORE a saved game, QUIT or UNDO the last command?

* * *

>talk to master
You can't see any such thing.

>talk to zyliath
Hello James, ohyeah I almost forgot here take my staff, this will deffinitly come in handy. With my old body I now spend my days reading and gardening its no use to me anymore.

>n
Trail
As you leave the town a dirt path is found underneath you. As you venture on further you find an opening to the forest to the east of you. Ahead of you the trail ends and seems to drop off?

>e
Forest
You reach the edge of the forest as you stand in front of tightly knit trees. You stare deep into the darkness ahead as if begging permission to enter. You slowly step into the massive realm of woodland and from the first footfall the whole atmosphere changes. The ground was spongy; the earth gently hugs your boots with each step. You look ahead and find a large dark oak tree. Its roots spread throughout the ground as if it were veins, almost as if it is the heart of the entire forest.

* * *

>x oak tree
You look more closely and find a mystic looking leather bound hand sized spell book placed on the outside of the tree.

>take book
You slowly remove the spell book as vines and bark slowly break and fall to the floor.

>w
Trail
As you leave the town a dirt path is found underneath you. As you venture on further you find an opening to the forest to the east of you. Ahead of you the trail ends and seems to drop off?

>x book
A mystic looking leather bound hand sized spell book, you slowly open it and find a word written inside of the book. It says PATHUS?

>n
Deep Crevice
Suddenly the trail ends. You look down and find a deep crevice with dark blue water rushing through it. As you look ahead you can see the Tower in the distance, this might be the time to use that spell you found.

* * *

>sw
Tower
You slowly enter the tower, and find yourself surrounded by Dungeon-like walls on everyside. You see an old door northwest of you and stairs northeast of you.

You can see Old Door here.

>ne
First floor

* * *

>nw
(first opening Old Door)
It seems to be locked.

>x wall
The bricks of the wall had started to crubmle and blacken in age, Cobwebs cover the walls and give you a sense of foreboding. You look more closely and notice a brick out of place?

* * *

>take brick
(Brick wall)
That's hardly portable.

>x brick
(Brick wall)
The bricks of the wall had started to crubmle and blacken in age, Cobwebs cover the walls and give you a sense of foreboding. You look more closely and notice a brick out of place?

I beg your pardon?

>take brick
(Brick wall)
That's hardly portable.

* * *

>talk to master zyliath
Hello James, I've known you since you were a child and look at you now im so proud to be your teacher. I almost forgot here take my staff, this will deffinitly come in handy who knows what you will run into on your adventure. With my old body I now spend my days reading and gardening its no use to me anymore. I wish you the best of luck james you can do it!

>n
Trail
As you leave the town a dirt path is found underneath you. As you venture on further you find an opening to the forest east of you. Ahead of you the trail ends and seems to drop off?

>talk to zyliath
You can't see any such thing.

>s
Draycott
Welcome to the town of Draycott. Crops are burnt to a crisp and livestalk is at an all time low. Houses are in ashes and there are no townspeople to be seen. As you head near the end of the town you see your Master Zyliath.

* * *

>talk to zyliath
Hello James, I've known you since you were a child and look at you now im so proud to be your teacher. I almost forgot here take my staff, this will deffinitly come in handy who knows what you will run into on your adventure. With my old body I now spend my days reading and gardening its no use to me anymore. I wish you the best of luck james you can do it!

>talk staff
I didn't understand that sentence.

>take staff
You already have that.

>n
Trail
As you leave the town a dirt path is found underneath you. As you venture on further you find an opening to the forest east of you. Ahead of you the trail ends and seems to drop off?

* * *

>e
Forest
You reach the edge of the forest as you stand in front of tightly knit trees. You stare deep into the darkness ahead as if begging permission to enter. You slowly step into the massive realm of woodland and from the first footfall the whole atmosphere changes. The ground was spongy; the earth gently hugs your boots with each step. You look ahead and find a large dark oak tree. Its roots spread throughout the ground as if it were veins, almost as if it is the heart of the entire forest.

>take tree
That's hardly portable.

>x tree
You look more closely and find a mystic looking leather bound hand sized spell book placed on the outside of the tree.

>take spell book
You slowly remove the spell book as vines and bark slowly break and fall to the floor. Suddenly you hear a thud behind you! As you slowly turn your head you notice a large darkness infront of you blocking your path.

>x darkness
You can't see any such thing.

>x defender
You see nothing special about Defender of the Forest.

>attack defender
You raise your staff in the air, an orb of blue light appears from your staff and strikes your opponent killing him in an instant. As the defender gets vaporized its heart slowly falls to the ground.
you now have the defender of the forest's heart.

>x heart
A heart made of pure emerald.

>take hear
You can't see any such thing.

>take heart
You already have that.

>w
Trail
As you leave the town a dirt path is found underneath you. As you venture on further you find an opening to the forest east of you. Ahead of you the trail ends and seems to drop off?

>w
You can't go that way.

>e
Forest
You reach the edge of the forest as you stand in front of tightly knit trees. You stare deep into the darkness ahead as if begging permission to enter. You slowly step into the massive realm of woodland and from the first footfall the whole atmosphere changes. The ground was spongy; the earth gently hugs your boots with each step. You look ahead and find a large dark oak tree. Its roots spread throughout the ground as if it were veins, almost as if it is the heart of the entire forest.

* * *

>n
Deep Crevice
Suddenly the trail ends. You look down and find a deep crevice with dark blue water rushing through it. As you look ahead you can see the Tower in the distance, this might be the time to use that spell you found.

>use spell
That's not a verb I recognise.

>x book
A mystic looking leather bound hand sized spell book, you slowly open it and find a word written inside of the book. It says PATHUS?

>pathus
A bridge was built in front of you!

>n
You can't go that way.

* * *

>cross bridge
Tower
You slowly enter the tower, and find yourself surrounded by Dungeon-like walls on everyside. You see an old door northwest of you and stairs northeast of you.

You can see Old Door here.

>x old door
You see nothing special about Old Door.

>open old door
It seems to be locked.

>ne
First floor
As you head up the stairs a deep roar echos through the tower. As you reach the top of the steps you find yourself surrounded by burnt dead corpses and dungeon-like walls. The whole feeling of the room creeps you out.

>x corpses
All of these people must have died trying to slay the dragon. As you search the dead bodies or whats left of them you find an onyx stone an extremly rare mage rock. East of you are stairs leading to the top of the tower.

* * *

>take onyx stone
Taken.

>x mage rock
You can't see any such thing.

>take rock
You can't see any such thing.

>e
Top of tower
As you take each step the whole atmosphere begins to change, as if a dark powerfull presence is watching your everystep. You soon reach the top of the tower, the wind blows rapidly into your face and clouds begin to form above you blocking out the sun. You look ahead and see the Dragon! It screaches out a roar and stares right into your eyes. Your heart starts rapidly speeding up! YOU NEED TO SLAY THE DRAGON NOW!

Fierce eyes sit deep within the dragon's skull. Two horns sit atop its head, several rows of small crystal growths run down the dragons spine. Colossal wings grow from its side, large ruby scales cover the dragon's body.

* * *

>talk to zyliat
You can't see any such thing.

>talk to zyliath
Hello James, I've known you since you were a child and look at you now I am so proud to be your teacher. I almost forgot here take my staff, this will definitely come in handy. Who knows what you will run into on your adventure. With my old body I now spend my days reading and gardening it's no use to me anymore. I wish you the best of luck James you can do it!

>n
Trail
As you leave the town a dirt path is found underneath you. As you venture on further you find an opening to the forest east of you. Ahead of you the trail keeps heading north.

* * *

>e
Forest
You reach the edge of the forest as you stand in front of tightly knit trees. You stare deep into the darkness ahead as if begging permission to enter. You slowly step into the massive realm of woodland and from the first footfall the whole atmosphere changes. The ground was spongy; the earth gently hugs your boots with each step. You look ahead and find a large dark oak tree. Its roots spread throughout the ground as if it were veins, almost as if it is the heart of the entire forest.

>take book
You slowly remove the spell book as vines and bark slowly break and fall to the floor. Suddenly you hear a thud behind you! You turn your head and find the Defender of the Forest approaching you! You have to attack the Defender of the Forest now!

>attack defender
You raise your staff in the air, an orb of blue light appears from your staff and strikes your opponent killing him in an instant. As the defender gets vaporized its heart slowly falls to the ground.
you now have the defender of the forest's heart.

>e
You can't go that way.

>w
Trail
As you leave the town a dirt path is found underneath you. As you venture on further you find an opening to the forest east of you. Ahead of you the trail keeps heading north.

* * *

>cross bridge
Tower
You slowly enter the tower, and find yourself surrounded by Dungeon-like walls on every side. The brick walls are covered in dust and cobwebs there must be something hidden within these walls. You see an old door northwest of you and stairs northeast of you.

You can see Old Door here.

>take brick
After taking the brick you see a Rusty key in its place, you reach your hand into the hole and grab the key.

>take key
You already have that.

>unlock door with key
You unlock Old Door.

* * *

>nw
(first opening Old Door)

Cellar
The door slowly creaks open; a musty smell fills your nose. The outdoor sunlight fills the darkened room. As your eyes adjust something shiny grabs your attention. You walk towards it and wipe off the thick layer of dust settling on the item, and notice its an Onyx stone!

You can see Old Door here.

>take stone
Taken.

>combine stone with heart
You now have Elemental Orb!
You combine the Defender of the Forests Heart and Onyx Stone to make Elemental orb, a powerful orb of magic and pure destruction. You need something to use this immense power... could the staff work?

I beg your pardon?

>combine stone
What do you want to combine Onyx Stone with?

>heart
You now have Elemental Orb!
You combine the Defender of the Forests Heart and Onyx Stone to make Elemental orb, a powerful orb of magic and pure destruction. You need something to use this immense power... could the staff work?

>forests heart
That's not a verb I recognise.

>combine defender of the forests heart
I didn't understand that sentence.

>combine onyx stone
What do you want to combine Onyx Stone with?

>heart
You now have Elemental Orb!
You combine the Defender of the Forests Heart and Onyx Stone to make Elemental orb, a powerful orb of magic and pure destruction. You need something to use this immense power... could the staff work?

>combine
What do you want to combine?

>heart and stone
You can't use multiple objects with that verb.

>combine heart
What do you want to combine the Forest Defender heart with?

>stone
You now have Elemental Orb!
You combine the Defender of the Forests Heart and Onyx Stone to make Elemental orb, a powerful orb of magic and pure destruction. You need something to use this immense power... could the staff work?

>combine heart with stone
You now have Elemental Orb!
You combine the Defender of the Forests Heart and Onyx Stone to make Elemental orb, a powerful orb of magic and pure destruction. You need something to use this immense power... could the staff work?

>combine heart
What do you want to combine the Forest Defender heart with?

* * *

>stone
You now have Elemental Orb!
You combine the Defender of the Forests Heart and Onyx Stone to make Elemental orb, a powerful orb of magic and pure destruction. You need something to use this immense power... could the staff work?

>onyx stone
That's not a verb I recognise.

>combine stone with heart
You now have Elemental Orb!
You combine the Defender of the Forests Heart and Onyx Stone to make Elemental orb, a powerful orb of magic and pure destruction. You need something to use this immense power... could the staff work?

>combine heart with stone
You now have Elemental Orb!
You combine the Defender of the Forests Heart and Onyx Stone to make Elemental orb, a powerful orb of magic and pure destruction. You need something to use this immense power... could the staff work?

>combine orb with staff
You now have Infinity staff!
You combine Zyliath's Magical staff and Elemental orb to make Infinity Staff, an immensely powerful staff that will defeat any foe you encounter.

>se
Tower
You slowly enter the tower, and find yourself surrounded by Dungeon-like walls on every side. The brick walls are covered in dust and cobwebs there must be something hidden within these walls. You see an old door northwest of you and stairs northeast of you.

You can see Old Door here.

I beg your pardon?

>ne
First floor
As you head up the stairs a deep roar echo's through the tower. As you reach the top of the steps you find yourself surrounded by burnt dead corpses and dungeon-like walls. The whole feeling of the room creeps you out.

* * *

>talk to zyliath
Hello James, I've known you since you were a child and look at you now I am so proud to be your teacher. I almost forgot here take my staff, this will definitely come in handy. Who knows what you will run into on your adventure. With my old body I now spend my days reading and gardening it's no use to me anymore. I wish you the best of luck James you can do it!

>n
Trail
As you leave the town, a dirt path is found underneath you. As you venture on further, you find an opening to the forest east of you. Ahead of you, the trail keeps heading north.

>e
Forest
You reach the edge of the forest as you stand in front of tightly knit trees. You stare deep into the darkness ahead as if begging permission to enter. You slowly step into the massive realm of woodland and from the first footfall, the whole atmosphere changes. The ground is spongy; the earth gently hugs your boots with each step. You look ahead and find a large dark oak tree. Its roots spread throughout the ground as if it were veins, almost as if it is the heart of the entire forest.

>take book
You slowly remove the spell book as vines and bark slowly break and fall to the floor. Suddenly you hear a thud behind you! You turn your head and find the Defender of the Forest approaching you! You have to attack the Defender of the Forest now!

>attack defender
When you raise your staff in the air, an orb of blue light appears from your staff and strikes your opponent killing him in an instant. As the Defender gets vaporized, his heart slowly falls to the ground.
You now have the Defender of the forest's heart.

>e
You can't go that way.

>n
You can't go that way.

>w
Trail
As you leave the town, a dirt path is found underneath you. As you venture on further, you find an opening to the forest east of you. Ahead of you, the trail keeps heading north.

>n
Deep Crevice
Suddenly the trail ends. You look down and find a deep crevice with dark blue water rushing through it. As you look ahead you can see the Tower in the distance, and this might be the time to use that spell you found.

>PATHUS
A bridge was built in front of you! You can now go on your way and cross over the bridge.

* * *

>n
You can't go that way.

>cross bridge
Tower
You slowly enter the tower, and find yourself surrounded by dungeon-like walls on every side. The brick walls are covered in dust and cobwebs and you feel like there must be something hidden within these walls. You see an old door northwest of you and stairs northeast of you.

You can see Old Door here.

>x walls
The bricks of the wall have started to crumble and blacken in age. Cobwebs cover the walls and give you a sense of foreboding. You look more closely and notice a brick out of place?

>x wall
The bricks of the wall have started to crumble and blacken in age. Cobwebs cover the walls and give you a sense of foreboding. You look more closely and notice a brick out of place?

* * *

>attack defender
When you raise your staff in the air, an orb of blue light appears from your staff and strikes your opponent killing him in an instant. As the Defender gets vaporized, his heart slowly falls to the ground.
You now have the Defender of the forest's heart.

>w
Trail
As you leave the town a dirt path is found underneath you. As you venture on further you find an opening to the forest east of you. Ahead of you the trail ends and seems to drop off?

* * *

>e
Forest
You reach the edge of the forest as you stand in front of tightly knit trees. You stare deep into the darkness ahead as if begging permission to enter. You slowly step into the massive realm of woodland and from the first footfall, the whole atmosphere changes. The ground is spongy; the earth gently hugs your boots with each step. You look ahead and find a large dark oak tree. Its roots spread throughout the ground as if it were veins, almost as if it is the heart of the entire forest.

>take spell book
You slowly remove the spell book as vines and bark slowly break and fall to the floor. Suddenly you hear a thud behind you! As you slowly turn your head you notice a large darkness infront of you blocking your path.

>w
Trail
As you leave the town a dirt path is found underneath you. As you venture on further you find an opening to the forest east of you. Ahead of you the trail ends and seems to drop off?

* * *

>n
You can't go that way.

>North
(Bridge)
Tower
You slowly enter the tower, and find yourself surrounded by Dungeon-like walls on everyside. You see an old door northwest of you and stairs northeast of you.

You can see Old Door here.

>N
You can't go that way.

* * *

>x Zyliath
You see nothing special about Zyliath.

>talk to zyliath
That's not a verb I recognise.

* * *

>x me
You are a young man.

>inventory
You are carrying nothing.

>n
Trail

* * *

>take book
You slowly remove the spell book as vines and bark slowly break and fall to the floor.

>x book
A mystic looking leather bound hand sized spell book, you slowly open it and find a word written inside of the book. It says PATHUS?

>w
Trail

* * *

>n
You can't go that way.

>cross bridge
tower

>cross bridge
tower

>s
You can't go that way.

* * *

>x zyliath
You see nothing special about Zyliath.

>talk to zyliath
Hello James, ohyeah I almost forgot here take my staff, this will deffinitly come in handy. With my old body I now spend my days reading and gardening its no use to me anymore.

>N
Trail

>E
Forest
You reach the edge of the forest as you stand in front of tightly knit trees. You stare deep into the darkness ahead as if begging permission to enter. You slowly step into the massive realm of woodland and from the first footfall the whole atmosphere changes. The ground was spongy; the earth gently hugs your boots with each step. You look ahead and find a large dark oak tree. Its roots spread throughout the ground as if it were veins, almost as if it is the heart of the entire forest.

>x tree
You look more closely and find a mystic looking leather bound hand sized spell book placed on the outside of the tree.

* * *

>take book
You slowly remove the spell book as vines and bark slowly break and fall to the floor.

>n
You can't go that way.